gravity = 0.1
width = 40
height = 15
tile_width = 16
tile_height = 16

[player]
aabb = { width = 12, height = 16 }
run_speed = 1.5
jump_speed = 3.2
fall_speed = 3
layer = 3

[[milestones]]
x = 2
y = 10

[[milestones]]
x = 20
y = 10

# BG / parallax layer 1
[[layers]]
tileset = "maps/tileset-outdoor.txt"
parallax = 0.25
repeat_x = true
# this is 22 tiles?
tiles = [
	[ 0,  0,  0,  0,  0,  0,  0,  0,  0,  0,  0,  0,  0,  0],
	[ 0,  0,  0,  0,  0,  0,  0,  0,  0,  0,  0,  0,  0,  0],
	[ 0,  0,  0,  0,  0,  0,  0,  0,  0,  0,  0,  0,  0,  0],
	[ 0,  0,  0,  0,  0,  0,  0,  0,  0,  0,  0,  0,  0,  0],
	[ 0,  0,  0,  0,  0,  0,  0,  0,  0,  0,  0,  0,  0,  0],
	[ 0,  0,  0,  0,  0,  0,  0,  0,  0,  0,  0,  0,  0,  0],
	[ 0,  0,  0,  0,  0,  0,  0,  0,  0,  0,  0,  0,  0,  0],
	[ 0,  0,  0,  0,  0,  0,  0,  0,  0,  0,  0,  0,  0,  0],
	[ 0,  0,  0,  0,  0,  0, 70,  0,  0,  0,  0,  0,  0,  0],
	[ 0,  0,  0,  0,  0, 77, 78, 81,  0,  0,  0,  0,  0,  0],
	[ 0,  0,  0,  0, 77, 78, 79, 80, 81,  0,  0,  0,  0,  0],
	[ 0,  0,  0, 77, 78, 79, 78, 79, 80, 81,  0,  0,  0,  0],
	[ 0,  0, 77, 78, 79, 78, 79, 80, 79, 80, 81,  0,  0,  0],
	[ 0, 77, 78, 79, 78, 79, 78, 79, 80, 79, 80, 81,  0,  0],
	[77, 78, 79, 78, 79, 78, 79, 78, 79, 80, 79, 80, 81,  0],
]

# BG / parallax layer 2
[[layers]]
tileset = "maps/tileset-outdoor.txt"
parallax = 0.5
repeat_x = true
# this should be 3/4x as wide, so 28? cells
tiles = [
	[ 0,  0,  0,  0,  0,  0,  0,  0,  0,  0,  0,  0,  0,  0,  0,  0,  0,  0,  0,  0],
	[ 0,  0,  0,  0,  0,  0,  0,  0,  0,  0,  0,  0,  0,  0,  0,  0,  0,  0,  0,  0],
	[ 0,  0,  0,  0,  0,  0,  0,  0,  0,  0,  0,  0,  0,  0,  0,  0,  0,  0,  0,  0],
	[ 0,  0,  0,  0,  0,  0,  0,  0,  0,  0,  0,  0,  0,  0,  0,  0,  0,  0,  0,  0],
	[ 0,  0,  0,  0,  0,  0,  0,  0,  0,  0,  0,  0,  0,  0,  0,  0,  0,  0,  0,  0],
	[ 0,  0,  0,  0,  0,  0,  0,  0,  0,  0,  0,  0,  0,  0,  0,  0,  0,  0,  0,  0],
	[ 0,  0,  0,  0,  0,  0,  0,  0,  0,  0,  0,  0,  0,  0,  0,  0,  0,  0,  0,  0],
	[ 0,  0,  0,  0,  0,  0,  0,  0,  0,  0,  0,  0,  0,  0,  0,  0,  0,  0,  0,  0],
	[ 0,  0,  0,  0,  0,  0,  0,  0,  0,  0,  0,  0,  0,  0,  0,  0,  0,  0,  0,  0],
	[ 0,  0,  0,  0,  0,  0,  0,  0,  0,  0,  0,  0,  0,  0,  0,  0,  0,  0,  0,  0],
	[ 0,  0,  0,  0,  0,  0,  0,  0,  0, 70,  0,  0,  0,  0,  0,  0,  0,  0,  0,  0],
	[ 0,  0,  0,  0,  0,  0,  0,  0, 77, 78, 81,  0,  0,  0,  0,  0,  0,  0,  0,  0],
	[ 0,  0,  0,  0,  0,  0,  0, 77, 78, 79, 80, 81,  0,  0,  0,  0,  0,  0,  0,  0],
	[ 0,  0,  0,  0,  0,  0, 77, 78, 79, 78, 79, 80, 81,  0,  0,  0,  0,  0,  0,  0],
	[ 0,  0,  0,  0,  0, 77, 78, 79, 78, 79, 80, 79, 80, 81,  0,  0,  0,  0,  0,  0],
]

[[layers]]
tileset = "maps/tileset-outdoor.txt"
tiles = [
	[ 0,  0,  0,  0,  0,  0,  0,  0,  0,  0,  0,  0,  0,  0,  0,  0,  0,  0,  0,  0,  0,  0,  0,  0,  0,  0,  0,  0,  0,  0,  0,  0,  0,  0,  0,  0,  0,  0,  0,  0],
	[ 0,  0,  0,  0,  0,  0,  0,  0,  0,  0,  0,  0,  0,  0,  0,  0,  0,  0,  0,  0,  0,  0,  0,  0,  0,  0,  0,  0,  0,  0,  0,  0,  0,  0,  0,  0,  0,  0,  0,  0],
	[ 0,  0,  0,  0,  0,  0,  0,  0,  0,  0,  0,  0,  0,  0,  0,  0,  0,  0,  0,  0,  0,  0,  0,  0,  0,  0,  0,  0,  0,  0,  0,  0,  0,  0,  0,  0,  0,  0,  0,  0],
	[ 0,  0,  0,  0,  0,  0,  0,  0,  0,  0,  0,  0,  0,  0,  0,  0,  0,  0,  0,  0,  0,  0,  0,  0,  0,  0,  0,  0,  0,  0,  0,  0,  0,  0,  0,  0,  0,  0,  0,  0],
	[ 0,  0,  0,  0,  0,  0,  0,  0,  0,  0,  0,  0,  0,  0,  0,  0,  0,  0,  0,  0,  0,  0,  0,  0,  0,  0,  0,  0,  0,  0,  0,  0,  0,  0,  0,  0,  0,  0,  0,  0],
	[ 0,  0,  0,  0,  0,  0,  0,  0,  0,  0,  0,  0,  0,  0,  0,  0,  0,  0,  0,  0,  0,  0,  0,  0,  0,  0,  0,  0,  0,  0,  0,  0,  0,  0,  0,  0,  0,  0,  0,  0],
	[ 0,  0,  0,  0,  0,  0,  0,  0,  0,  0,  0,  0,  0,  0,  0,  0,  0,  0,  0,  0,  0,  0,  0,  0,  0,  0,  0,  0,  0,  0,  0,  0,  0,  0,  0,  0,  0,  0,  0,  0],
	[ 0,  0,  0,  0,  0,  0,  0,  0,  0,  0,  0,  0,  0,  0,  0,  0,  0,  0,  0,  0,  0,  0,  0,  0,  0,  0,  0,  0,  0,  0,  0,  0,  0,  0,  0,  0,  0,  0,  0,  0],
	[ 0,  0,  0,  0,  0,  0,  0,  0,  0,  0,  0,  0,  0,  0,  0,  0,  0,  0,  0,  0,  0,  0,  0,  0,  0,  0,  0,  0,  0,  0,  0,  0,  0,  0,  0,  0,  0,  0,  0,  0],
	[ 0,  0,  0,  0,  0,  0,  0,  0,  0,  0,  0,  0,  0,  0,  0,  0,  0,  0,  0,  0,  0,  0,  0,  0,  0,  0,  0,  0,  0,  0,  0,  0,  0,  0,  0,  0,  0,  0,  0,  0],
	[ 0,  0,  0,  0,  0,  0,  0,  0,  0,  0,  0,  0,  0,  0,  0,  0,  0,  0,  0,  0,  0,  0,  0,  0,  0,  0,  0,  0,  0,  0,  0,  0,  0,  0,  0,  0,  0,  0,  0,  0],
	[ 0,  0,  0,  0,  0,  0,  0,  0,  0,  0,  0,  0,  0,  1,  0,  0,  0,  0,  0,  0,  0,  0,  0,  0,  0,  0,  0,  0,  0,  0,  0,  0,  0,  0,  0,  0,  0,  0,  0,  0],
	[ 0,  0,  0,  0,  0,  0,  0,  0,  0,  0,  0,  0,  1,  1,  0,  0,  1,  0,  0,  0,  0,  0,  0,  0,  0,  0,  0,  0,  0,  0,  0,  0,  0,  0,  0,  0,  0,  0,  0,  0],
	[ 1,  1,  1,  1,  1,  1,  1,  1,  1,  1,  1,  1,  1,  1,  0,  0,  1,  1,  1,  1,  1,  1,  1,  1,  1,  1,  1,  1,  1,  1,  1,  1,  1,  0,  0,  0,  1,  1,  1,  1],
	[ 1,  1,  1,  1,  1,  1,  1,  1,  1,  1,  1,  1,  1,  1,  0,  0,  1,  1,  1,  1,  1,  1,  1,  1,  1,  1,  1,  1,  1,  1,  1,  1,  1,  0,  0,  0,  1,  1,  1,  1],
]

[[layers]]
# entity layer, so it's empty!

[[layers]]
tileset = "maps/tileset-outdoor.txt"

# Layers could specify tiles as tables with more detail.
# any tile NOT specified is assumed 0.
[[layers.tiles]]
id = 2 # uses the same ID as the tiles though
# position is tiles, not pixels.
x = 8
y = 7

[[layers.tiles.events]]
script = "scripts/coinblock.wut"
vars = { coins = 5 }
events = ["collide"]

[[layers.tiles]]
id = 2
x = 4
y = 10

[[layers.tiles.events]]
script = "scripts/shatterblock.wut"
events = ["collide"]

[[layers.tiles]]
id = 2
x = 6
y = 10

[[layers.tiles.events]]
script = "scripts/shatterblock.wut"
events = ["collide"]

[[layers.tiles]]
id = 2
x = 8
y = 10

[[layers.tiles.events]]
script = "scripts/shatterblock.wut"
events = ["collide"]

[[layers.tiles]]
id = 2
x = 10
y = 10

[[layers.tiles.events]]
script = "scripts/shatterblock.wut"
events = ["collide"]


[[layers.tiles]]
id = 36
x = 7
y = 10

[[layers.tiles.events]]
script = "scripts/coinblock.wut"
vars = { coins = 1 }
events = ["collide"]

[[layers.tiles]]
id = 36
x = 9
y = 10

[[layers.tiles.events]]
script = "scripts/coinblock.wut"
vars = { coins = 2 }
events = ["collide"]
